17x11x200x800
3-4x10-12
00220222020222022
01210121012101210
20002222002002022
21010101210101010
20020022222002002
01010101010101210
00200020002000200
21010101010101012
20222200220022000
01010101012101212
00020220002002000
