17x11x181x1000
0-4x6-0x2-11x10-2x6-6x6-10x10-16
00220020200202002
01010101010101010
20200200022022202
01010101010101010
22020202020200202
01010101010101010
02202002220022022
21010101010101010
00202002022200200
01010101012101010
22002000202002020