17x11x181x1000
0-7x6-2x1-14x3-10x7-16
00200020000200002
01210101010101010
00022000200002000
21010101010101010
00002000002000000
01010101010121010
02000200200002000
01012101010101010
20000200000000002
01010101012101010
00200000000220000