17x11x100x800
3-4x10-16
00000000000000000
01010101010101010
00000000000000000
01010101010101010
20000000000000000
01010101010101010
00000000000000000
01010101010101010
00000000000000000
01010101010101010
00000000000000000